Due Date of Payment,Opening Balance,EMI/ Amount paid,Interest,Principal,Closing Balance
1/1/2018,1000.0,173.54,11.67,161.87,838.13
1/2/2018,838.13,173.54,9.78,163.76,674.37
1/3/2018,674.37,173.54,7.87,165.67,508.7
1/4/2018,508.7,173.54,5.93,167.6,341.1
1/5/2018,341.1,173.54,3.98,169.56,171.54
1/6/2018,171.54,173.54,2.0,171.54,0.0
